1 13 31
###############################
#p     ** * 1  *   *  * * *   #
# # # #*# # #*#*# # # #*#*#*# #
#b  *     ***  *      *   * * #
# # # # # #*# # #*#*# # # # #*#
#         x **  *  *    2     #
# # # # # # # # # #*# #*# # # #
#*  * s    *  *      *        #
# # # # #*# # # #*#*# # # # # #
#* f  **  *       *  2        #
# #*# # # # # # #*# # # # # # #
#   1       *   *  *          #
###############################